NO assets/brick.png
SO assets/img.png
WE assets/img2.png
EA assets/img3.png

F 127,129,130
C 49,151,214

        1111111111111111111111111
        1000000000110000000000001
        1011000001110000000000001
        100100000000000000N000001
111111011011000001110000000000001
100000000011000001110111111111111
001110111111111011100000010000
11110111111111011101010010001
11000000110101011100000010001
10000000000000001100000010001
10000000000000001101010010001
110000011101010101110111100111
11110110 1110101 101111010001
11111111 1111111 011111111001
